R 600 600
NO textures/wall_n.xpm
SO textures/wall_s.xpm
WE textures/wall_w.xpm
EA textures/wall_e.xpm
S pics/barrel.xpm
C 255,255, 0
F 255,255,255


        1111111111111111111111111
        1000000000110000000000001
        1011000001110000002000001
        1001000000000000000000W01
111111111011000001110000000000001
100000000011000001110111111111111
11110111111111011100000010001
11110111111111000001010000201
11000000110101000000000000001
10002000000000000000000000001
10000000000000001101010010001
11000001110101011111011110001
11110111 1110101 101111010001
11111111 1111111 111111111111
